====================
=G=..====..........=
=.==.=============.=
=.==.........=====.=
=.==========.=====.=
=.=======..........=
=.=.......========.=
=.=======.========.=
=.=.............==.=
=.=.================
=.=................=
=.================.=
=.=...=............=
=.=.=.=.=.==========
=.=.=.=.=..........=
=.=.=.=.=.==========
=.=.=.=.=..........=
=.=.=.=.=.==========
=...=...=.........<=
====================