====================
=G=................=
=.==========.=======
=.......====.=======
=======.====.=======
=======.====.=======
=======.====.=======
=======.====.=======
=======.====.=======
=======.====.=======
=======.====.=======
=======.====.=======
=.......====.=======
=.=====.====.=======
=.==.........==...^=
=.==========.==.====
=.==========.==.====
=.==========.==.====
=.==========.......=
====================