====================
==.=.=.=.=.=.=.=.=.=
=..=.=.=.=.=.=.=.=.=
==.=.=.=.=.=.=.=.=.=
=..=.=.=.=.=.=.=.=.=
==.=.=.=.=.=.=.=.=.=
=..=.=.=.=.=.=.=.=.=
==.=.=.=.=.=.=.=.=.=
=.................<=
==.=.=.=.=.=.=.=.=.=
=..=.=.=.=.=.=.=.=.=
==.=.=.=.=.=.=.=.=.=
=..=.=.=.=.=.=.=.=.=
==.=.=.=.=.=.=.=.=.=
=..=.=.=.=.=.=.=.=.=
==.=.=.=.=.=.=.=.=.=
=..=.=.=.=.=.=.=.=.=
==.=.=.=.=.=.=.=.=.=
=..=.=.=.=.=.=.=.=G=
====================