====================================================================================
=..................................................................................=
=.================================================================================.=
=.==========G..............................=======================================.=
=.========================================.=====...................................=
=.==================================.=====.=====.===================================
=.==================================.=====.=====.===================================
=.......................................==.=====.===================================
=.==================================.=====.=====.===================================
=.==================================.=====.=====.===================================
=.==================================.=====.=====.===================================
=.==================================.=====.=====...........................=========
=.==================================.=====.=====.===================================
=.==================================.=====.=====.===================================
=.==================================.=====.=====.===================================
=.======.............===============.=====.=====.===================================
=.======.===========================.=====.=====.===================================
=.======.=================================.=====.===================================
=.======.==========........................=====.===================================
=.======.==========.============================.===================================
=.======.==========.============================.===================================
=.======.==========.============================.===================================
=.======......................==================.===================================
=.======.=======================================.===================================
=.=................................................................................=
=.==============================================v===================================
====================================================================================