====================
====================
====================
=========.==========
=========.==========
=========.==========
=========.==========
=========.==========
=========.==========
=G.................=
=========.==========
=========.==========
=========.==========
=========.==========
=========.==========
=========.==========
=========.==========
=========.==========
=========^==========
====================