====================
====================
====================
====================
====================
====================
====================
=========.....======
=========.==========
=========G==========
=========.==========
=========.==.....===
=========.==.=======
======........======
=============....===
=======.......======
=============.======
==========<...======
====================
====================